лл лллллллл
л         л
ллллллллл л
л         л
ллллл ллл л
л л     л  
л ллллл ллл
л     л   л
ллл ллл ллл
л         л
ллллллллллл
